### Constants ###
G = 6.674 * 10^-11 - Gravitational constant
pi = 3.14159265 - pi constant



### Variables ###
i = phisics tck per second (unwarped)
i_w = phisics tck per second (warped)
warp = warp multiplier
P, P1, P2 = position vectors (P1 is more massive body)
Pr = relative position vector
v, v1, v2 = velocity vectors (v1 is more massive body)
vr = relative velocity vector
|vr| = relative velocity magnitude
vr_a = angle of relative velocity vector
m = mass in Kg
ac = acceleration
av = acceleration vector
F = force
rCOI = radius of circle of influence
d = distance (height)
ev = eccentricity vector
e = eccentricity
u = standard gravitational parameter
a = semi-major axis
b = semi-minor axis
f = focus
omega = argument of periapsis
p = omega   # to save space

Pe = periapsis
Ap = apoapsis
Pev = periapsis vector
Apv = apoapsis vector
Ta = true anomaly
Ea = eccentric anomaly
Da = Parabolic eccentric anomaly
Fa = Hyperbolic eccentric anomaly
Lat = latitude - angular displacement from argument of periapsis
Ma = mean anomaly
T = orbital priod
n = mean motion
tPe = time to periapsis from current position
tAp = time to apoapsis from current position



### System ###
i_w = i * w   # warped physics tick
all calculated times are at end divided by i
(Apt, Pet, T)
